Uma Fisher         - uma.fisher@example.com
Violet Morgan      - violet.morgan@example.com
Wyatt Long         - wyatt.long@example.com
Zoey Bennett       - zoey.bennett@example.com
Amber Brooks       - amber.brooks@example.com
Brandon Simmons    - brandon.simmons@example.com
Carly Foster       - carly.foster@example.com
Declan Gonzales    - declan.gonzales@example.com
Eleanor Bryant     - eleanor.bryant@example.com
Felix Hayes        - felix.hayes@example.com
Grace Butler       - grace.butler@example.com
Henry Barnes       - henry.barnes@example.com
Ivy Gray           - ivy.gray@example.com
Jake Lopez         - jake.lopez@example.com
Kylie Ortiz        - kylie.ortiz@example.com
Logan Ramirez      - logan.ramirez@example.com
Mia Parker         - mia.parker@example.com
Nathan James       - nathan.james@example.com
Olivia Cooper      - olivia.cooper@example.com
Patrick Turner     - patrick.turner@example.com
Quinn Flores       - quinn.flores@example.com
Rose Foster        - rose.foster@example.com
Samuel Butler      - samuel.butler@example.com
Tessa Sanders      - tessa.sanders@example.com
Uriel Powell       - uriel.powell@example.com
Victor Torres      - victor.torres@example.com
Willow Rivera      - willow.rivera@example.com
Xander Perry       - xander.perry@example.com
Yasmin Ward        - yasmin.ward@example.com
Zane Bennett       - zane.bennett@example.com
Addison Mitchell   - addison.mitchell@example.com
Blake Ross         - blake.ross@example.com
Charlotte Cox      - charlotte.cox@example.com
Daniel Rivera      - daniel.rivera@example.com
Emma James         - emma.james@example.com
Finley Diaz        - finley.diaz@example.com
Gabriella Reyes    - gabriella.reyes@example.com
Hudson Lewis       - hudson.lewis@example.com
Isla Morgan        - isla.morgan@example.com
Jonah Campbell     - jonah.campbell@example.com
Kiera Perez        - kiera.perez@example.com
Lucas Taylor       - lucas.taylor@example.com
Madison White      - madison.white@example.com
Nolan Brown        - nolan.brown@example.com
Olivia Ward        - olivia.ward@example.com
Preston Torres     - preston.torres@example.com
Quinn Carter       - quinn.carter@example.com
Riley Hayes        - riley.hayes@example.com
Sophia Miller      - sophia.miller@example.com
Tristan King       - tristan.king@example.com
Violet Scott      - violet.scott@example.com