Alice Smith       - alice.smith@example.com
Bob Johnson       - bob.johnson@example.com
Charlie Brown     - charlie.brown@example.com
Diana Miller      - diana.miller@example.com
Ethan Davis       - ethan.davis@example.com
Fiona Wilson      - fiona.wilson@example.com
George Moore      - george.moore@example.com
Hannah Taylor     - hannah.taylor@example.com
Ian Anderson      - ian.anderson@example.com
Jenna Thomas     - jenna.thomas@example.com
Kevin Jackson    - kevin.jackson@example.com
Laura White      - laura.white@example.com
Michael Harris   - michael.harris@example.com
Nora Clark       - nora.clark@example.com
Oscar Lewis      - oscar.lewis@example.com
Paula Hall       - paula.hall@example.com
Quentin Allen    - quentin.allen@example.com
Rachel Young     - rachel.young@example.com
Samuel King      - samuel.king@example.com
Tina Wright      - tina.wright@example.com
Victor Scott     - victor.scott@example.com
Wendy Green      - wendy.green@example.com
Xavier Adams     - xavier.adams@example.com
Yasmine Baker    - yasmine.baker@example.com
Zachary Carter   - zachary.carter@example.com
Olivia Brooks    - olivia.brooks@example.com
Liam Murphy      - liam.murphy@example.com
Emma Reed        - emma.reed@example.com
Noah Price       - noah.price@example.com
Chloe Barnes     - chloe.barnes@example.com